Hi, my name is Sagar Jayantilal Satra and I have created a simple E-commerce website for shopping Customized Print Products.
Earier I was in printing business and liked the idea of creating a website where users can create their own print products as per their personalized design.

I have created two pages 
1. Printing Hub (For personalized stationary and other products)
2. Gift Hub (Gifting customized print product to others).

I have used the following tags:
1. head - standard tag
2. body - standard tag
3. href - for linking images, vides, relative and absolute links.
4. rel - for linking CSS file
5. header - introductory tag
6. main - for main body content
7. footer - for closing informations
8. nav - for navigating to links and sections of the website
9. class - for assigning properties to various elements / groups
10. id - unique IDs given for unique elements.
11. a - anchor tag for creating hyperlinks
12. detail - for displaying additional data of products in the website
13. Summary - for displaying short summary of the whole data.
14. br - for putting line breaks in the website
15. hr - creating a horizontal line for better visual.
16. h1, h2,h3 - heading tags
17. favicon - to display an icon in the title of webpage
18. Table - for putting size/data information of the products
19. images - for displaying the product in the website
20. video - to embed a video for product displaying.
21. audio - for describing the content in the website.
22. tel and mail to - for displaying contact information in the website
23. menu - for listing the product items in an unordered way.
24. radio button - for making selection of a particular item from group of items.
25. select and option - for making selection from a list of options
26. submit - for submiting the data / information entered in the fields
27. forms - for entering and selecting the desired category of products.

  